11111111111
1P1111111E1
10000000001
1CCC111CCC1
11111111111