11111111111
1P1111111E1
10000000001
1CC111000C1
11111110111