11111
1P001
1C0C1
10E01
111111



