11111111111
1P00C011101
10001011101
1C000E11101
11111111111








