11111
1P0P1
1C0C1
10E01
11111
