1111111111
1P00000001
1C00000C01
1C00000111
10000000E1
1111111111
