1111111
1P00C01
1000101
1C000E1
1111111