111111111111111
1P0000000000001
101110011111101
1C0E00010000001
111110011000001
100000000000001
1C0000000000001
111111111111111
