1111111111
1P000000E1
1110111011
1C001000C1
1C111101C1
1111111111
