111111111111111
1P0000000010001
111011111101101
1C00000000000E1
1C0111011001111
1C0000000010001
1110111111011101
111111111111111
