11111111111
1C1111111E1
10000000001
1CC111000C1
11111111111